wwwwwwwwwwwwwwwwwwwwww
ww.....w........w....w
ww.ww..ww.......w...ew
ww.ww...6....ww......w
ww.wwwwwwwwwwwwwwwwwww
ww.ww....w...........w
ww.......w..E....wwwww
ww.ww................w
ww.wwwwwwwwwwwwwwwwwww
ww.ww........w.......w
ww........w..w..w....w
ww.ww.....4.....5....w
ww.wwwwwww...w.......w
ww.ww....w...3...wwwww
ww.ww....www.........w
ww..2.1.Aw...........w
wwwwww...wwwwwwwwwwwww
wwwwwwwwwwwwwwwwwwwwww