wwwwwwwwwwwwwwwwwwwwww
ww.....w........w....w
ww.ww..ww.......w...ew
ww.ww...6....ww......w
ww.wwwwwwwwwwwwwwwwwww
ww.ww....w...........w
ww.......w..E....wwwww
ww.ww................w
ww.wwwwwwwwwwwwwwwwwww
ww.ww........w.......w
ww.....3..w..w..w....w
ww.ww.....4.....5....w
ww.wwwwwww...w.......w
ww.ww....w.......wwwww
ww.ww....www.........w
ww1.....2.wA.........w
wwwwww...wwwwwwwwwwwww
wwwwwwwwwwwwwwwwwwwwww