wwwwwwwwwwwwwwwwwwwwww
ww.....w5.......w...6w
ww.ww..ww.......w....w
ww.ww........ww......w
ww.wwwwwwwwwwwwwwwwwww
ww.ww....w...........w
ww.......w...3...wwwww
ww.ww................w
ww.wwwwwwwwwwwwwwwwwww
ww.ww........w.....1.w
ww.......4...w..w....w
ww.ww................w
ww.wwwwwww...w.......w
ww.ww....w..2....wwwww
ww.ww....www.........w
ww....e...wA....w....w
wwwwww...wwwwwwwwwwwww
wwwwwwwwwwwwwwwwwwwwww